CARD	NUM
CJ	C
CN	N
DA	D
DEM	D
DGT	NUM
DM	INTJ
GER	VB-G
GERAUX	VB-G
IA	D
IND	Q
INT	WPRO
ITJ	INTJ
ORD	ADJ
MTH	NPR
PNT	.
PNM	NPR
POSS	PRO$
PPA	VB-AN
PPT	VB-PP
PREP	P
PRS	PRO
QNT	Q
REL	WPRO
STT	NPR
UM	D
UMA	D
V	VB-FIN
INF	VB
WD	NPR